..........................
..........................
..~~~~.#..--..-..@@.%..%..
..~...#.#.--..-.@..@%..%..
..~...#.#.-.-.-@....%..%..
..~~~.#.#.-.-.-@....%..%..
..~..#...#-.-.-@.....%%...
..~..#####-..--@.....%%...
..~..#...#-..--.@..@.%%...
..~..#...#-..--..@@..%%...
..........................
..........................
......##.......@@.........
.....#..#.....@..@........
....#........@....@.......
....#........@....@.......
....#........@....@.......
....#..##....@....@.......
.....#..#.....@..@........
......###......@@.........
..........................
..........................
..........................
...........####...........
...........#..#...........
...........#..#...........
